################
#X#    @       #
# #            #
# #       o  # #
# #   d      # #
# #       g  # #
# #          # #
# # s        # #
# #     l  d # #
# #  x       # #
# #     c    # #
# #  v       # #
# #          # #
# ############ #
#              #
################
